10
1 8 8 1
1111111101
0000000101
0111110101
0001000101
1101011101
0001010001
0111010111
0101010101
0001010101
0001000001

